00000000000000000000000000000000000000000000000000
01111010111111011111111111111111111111111111011000
01111011111010000111111111111111111011111111111000
01111111111011111111111111111110111011001111111100
01101110111011111111111111111110011111101000011000
01101110111001110011100111100111011110101100001000
01100110001001111111111000111111011111101111111000
01101110011101111111110100011111011111111011100000
01101110011101111111110111110111000000001011111000
01001100001111110111110000000000000011011011111000
01001111101111110101110111110000011111011001101100
01001011101110000101010111100011101111011001101100
00001011111110110101000110100011000000011101001100
00011010111100011111010000000011101111000000001100
02110010110000011111111111101011001101011101100113
00110010111000011110000000001011011101000101101100
00000000011010000011111110001110011100000000001100
01111111011011000111111110111111011100111101101100
01110000000000011100000000001111011001111101111100
00000000000000000000000000000000000000000000000000
